{
  "grid": [
    [0,0,0,0,0,0,0,0,0,0,0,0,0,0,0,0,0,0,0,0],
    [0,1,1,1,1,1,1,1,1,1,0,1,1,1,1,1,1,1,1,0],
    [0,0,0,0,0,0,0,0,0,1,0,1,0,0,0,0,0,0,0,0],
    [0,1,1,1,1,1,1,1,0,1,0,1,0,1,1,1,1,1,1,0],
    [0,0,0,0,0,0,0,0,0,1,0,1,0,0,0,0,0,0,0,0],
    [0,1,1,1,1,1,1,1,0,1,0,1,0,1,1,1,1,1,1,0],
    [0,0,0,0,0,0,0,0,0,1,0,1,0,0,0,0,0,0,0,0],
    [0,1,1,1,1,1,1,1,0,1,0,1,0,1,1,1,1,1,1,0],
    [0,0,0,0,0,0,0,0,0,1,0,1,0,0,0,0,0,0,0,0],
    [1,1,1,1,1,1,1,1,0,1,0,1,0,1,1,1,1,1,1,1],
    [0,0,0,0,0,0,0,0,0,1,0,1,0,0,0,0,0,0,0,0],
    [0,1,1,1,1,1,0,1,1,1,1,1,1,0,1,1,1,1,1,0],
    [0,0,0,0,0,0,0,0,0,1,0,1,0,0,0,0,0,0,0,0],
    [0,1,1,1,1,1,1,1,0,1,0,1,0,1,1,1,1,1,1,0],
    [0,0,0,0,0,0,0,0,0,1,0,1,0,0,0,0,0,0,0,0],
    [0,1,1,1,1,1,1,1,0,1,0,1,0,1,1,1,1,1,1,0],
    [0,0,0,0,0,0,0,0,0,1,0,1,0,0,0,0,0,0,0,0],
    [0,1,1,1,1,1,1,1,0,1,0,1,0,1,1,1,1,1,1,0],
    [0,0,0,0,0,0,0,0,0,1,0,1,0,0,0,0,0,0,0,0],
    [0,1,1,1,1,1,1,1,1,1,0,1,1,1,1,1,1,1,1,0]
  ],
  "start": [0, 10],
  "exit": [19, 10],
  "rewards": [
    [[10, 2], 5],
    [[10, 18], 10]
  ],
  "swap_prob": 1.0
} 