{
  "grid": [
    [0,0,0,0,0,0,0,0,0,0,0,1,1,1,1,1,1,1,1,1],
    [1,1,1,1,1,1,1,1,1,1,0,1,1,1,1,1,1,1,1,1],
    [1,1,1,1,1,1,1,1,1,1,0,1,1,1,1,1,1,1,1,1],
    [1,1,1,1,1,1,1,1,1,1,0,1,1,1,1,1,1,1,1,1],
    [1,1,1,1,1,1,1,1,1,1,0,1,1,1,1,1,1,1,1,1],
    [1,1,1,1,1,1,1,1,1,1,0,1,1,1,1,1,1,1,1,1],
    [1,1,1,1,1,1,1,1,1,1,0,1,1,1,1,1,1,1,1,1],
    [1,1,1,1,1,1,1,1,1,1,0,1,1,1,1,1,1,1,1,1],
    [1,1,1,1,1,1,1,1,1,1,0,1,1,1,1,1,1,1,1,1],
    [1,1,1,1,1,1,1,1,1,1,0,1,1,1,1,1,1,1,1,1],
    [1,1,1,1,1,1,1,1,1,1,0,0,0,0,0,0,1,1,1,1],
    [1,1,1,1,1,1,1,1,1,1,0,1,1,1,1,1,1,1,1,1],
    [1,1,1,1,1,1,1,1,1,1,0,1,1,1,1,1,1,1,1,1],
    [1,1,1,1,1,1,1,1,1,1,0,1,1,1,1,1,1,1,1,1],
    [1,1,1,1,1,1,1,1,1,1,0,1,1,1,1,1,1,1,1,1],
    [1,1,1,1,1,1,1,1,1,1,0,1,1,1,1,1,1,1,1,1],
    [1,1,1,1,1,1,1,1,1,1,0,1,1,1,1,1,1,1,1,1],
    [1,1,1,1,1,1,1,1,1,1,0,1,1,1,1,1,1,1,1,1],
    [1,1,1,1,1,1,1,1,1,1,0,1,1,1,1,1,1,1,1,1],
    [1,1,1,1,1,1,1,1,1,1,0,0,0,0,0,0,0,0,0,0]
  ],
  "start": [0, 0],
  "exit":  [19, 19],
  "rewards": [
    [[10, 15], 10],
    [[14, 10], 5]
  ],
  "swap_steps": [],
  "swap_prob": 0.0
}
