{
    "grid": [
      [1,1,1,1,1,1,1,1,1,1,1,1,1,1,1,1,1,1,1,1],
      [1,1,1,1,1,1,1,1,1,1,1,1,1,1,1,1,1,1,1,1],
      [1,1,1,1,1,1,1,1,1,1,1,1,1,1,1,1,1,1,1,1],
      [1,1,1,1,1,1,1,1,1,1,1,1,1,1,1,1,1,1,1,1],
      [1,1,1,1,1,1,1,1,1,1,1,1,1,1,1,1,1,1,1,1],
      [1,1,1,1,1,1,1,1,1,1,1,1,1,1,1,1,1,1,1,1],
      [1,1,1,1,1,1,1,1,1,1,1,1,1,1,1,1,1,1,1,1],
      [1,1,1,0,0,0,0,0,0,0,0,0,0,0,0,0,0,1,1,1],
      [1,1,1,0,1,1,1,1,1,1,1,1,1,1,1,1,0,1,1,1],
      [1,1,1,0,1,1,1,1,1,1,1,1,1,1,1,1,0,1,1,1],
      [0,0,0,0,0,0,0,0,0,0,0,0,0,0,0,0,0,0,0,0],
      [1,1,1,0,1,1,1,1,1,1,1,1,1,1,1,1,0,1,1,1],
      [1,1,1,0,1,1,1,1,1,1,1,1,1,1,1,1,0,1,1,1],
      [1,1,1,0,0,0,0,0,0,0,0,0,0,0,0,0,0,1,1,1],
      [1,1,1,1,1,1,1,1,1,1,1,1,1,1,1,1,1,1,1,1],
      [1,1,1,1,1,1,1,1,1,1,1,1,1,1,1,1,1,1,1,1],
      [1,1,1,1,1,1,1,1,1,1,1,1,1,1,1,1,1,1,1,1],
      [1,1,1,1,1,1,1,1,1,1,1,1,1,1,1,1,1,1,1,1],
      [1,1,1,1,1,1,1,1,1,1,1,1,1,1,1,1,1,1,1,1],
      [1,1,1,1,1,1,1,1,1,1,1,1,1,1,1,1,1,1,1,1]
    ],
    "start": [10, 0],
    "exit": [10, 19],
    "rewards": [
      [[7, 10], 5],
      [[13, 10], 10]
    ],
    "swap_prob": 1
  }
  