{
  "grid": [
    [0,0,0,0,0,0,0,0,0,0,1,0,0,0,0,0,0,0,0,0],
    [0,1,1,1,0,1,0,1,1,0,1,0,1,1,1,0,1,0,1,0],
    [0,0,0,1,0,0,0,0,1,0,1,0,0,0,1,0,0,0,1,0],
    [0,1,0,1,1,1,1,0,1,0,1,1,1,0,1,1,1,0,1,0],
    [0,1,0,0,0,0,1,0,0,0,0,0,1,0,0,0,1,0,0,0],
    [0,1,1,1,1,0,1,1,1,1,1,0,1,1,1,0,1,1,1,0],
    [0,0,0,0,1,0,0,0,0,0,1,0,0,0,1,0,0,0,0,0],
    [1,1,1,0,1,1,1,0,1,0,1,0,1,0,1,1,1,1,1,0],
    [0,0,0,0,0,0,1,0,0,0,0,0,1,0,0,0,0,0,0,0],
    [0,1,1,1,1,0,1,1,1,1,1,0,1,1,1,1,1,0,1,0],
    [0,1,0,0,0,0,0,0,0,0,0,0,0,0,0,0,1,0,1,0],
    [0,1,0,1,1,1,1,1,1,1,1,1,1,1,1,0,1,0,1,0],
    [0,0,0,1,0,0,0,0,1,0,0,0,0,0,1,0,0,0,1,0],
    [0,1,1,1,0,1,1,0,1,0,1,1,1,0,1,1,1,0,1,0],
    [0,0,0,0,0,0,1,0,0,0,0,0,1,0,0,0,0,0,0,0],
    [0,1,1,1,1,0,1,1,1,1,1,0,1,1,1,1,1,0,1,0],
    [0,1,0,0,0,0,0,0,0,0,0,0,0,0,0,0,1,0,0,0],
    [0,1,0,1,1,1,1,1,1,1,1,1,1,1,1,0,1,1,1,0],
    [0,0,0,0,0,0,0,0,0,0,1,0,0,0,0,0,0,0,0,0],
    [0,1,1,1,1,1,1,1,1,0,1,1,1,1,1,1,1,1,1,0]
  ],
  "start": [0, 0],
  "exit": [19, 19],
  "rewards": [
    [[0, 19], 5],
    [[19, 0], 10]
  ],
  "swap_steps": [50, 100, 150],
  "swap_prob": 0.5
}
