{
  "grid": [
    [0,0,0,0,0,0,0,0,0,0,0,0,0,0,0,0,0,0,0,0],
    [0,1,1,1,1,1,1,1,0,1,0,1,0,1,1,1,1,1,1,0],
    [0,0,0,0,0,0,0,0,0,1,0,1,0,0,0,0,0,0,0,0],
    [0,1,1,1,1,1,1,1,1,1,0,1,1,1,1,1,1,1,1,0],
    [0,0,0,0,0,0,0,0,0,0,0,0,0,0,0,0,0,0,0,0],
    [0,1,0,1,1,1,1,1,0,1,1,1,0,1,1,1,1,0,1,0],
    [0,1,0,0,0,0,0,1,0,1,1,1,0,1,0,0,0,0,1,0],
    [0,1,1,1,1,1,0,1,0,1,1,1,0,1,0,1,1,1,1,0],
    [0,0,0,0,0,0,0,0,0,1,1,1,0,0,0,0,0,0,0,0],
    [1,1,1,0,1,1,1,1,0,1,1,1,0,1,1,1,1,0,1,1],
    [0,0,0,0,0,0,0,0,0,1,1,1,0,0,0,0,0,0,0,0],
    [0,1,1,1,1,1,0,1,1,1,1,1,1,1,0,1,1,1,1,0],
    [0,0,0,0,0,0,0,0,0,1,1,1,0,0,0,0,0,0,0,0],
    [0,1,1,1,1,1,1,1,0,1,1,1,0,1,1,1,1,1,1,0],
    [0,1,0,0,0,0,0,1,0,1,1,1,0,1,0,0,0,0,1,0],
    [0,1,0,1,1,1,0,1,0,1,1,1,0,1,0,1,1,0,1,0],
    [0,1,0,0,0,1,0,0,0,1,1,1,0,0,0,1,0,0,1,0],
    [0,1,1,1,0,1,1,1,1,1,1,1,1,1,1,1,0,1,1,0],
    [0,0,0,0,0,0,0,0,0,0,0,0,0,0,0,0,0,0,0,0],
    [0,1,1,1,1,1,1,1,1,1,0,1,1,1,1,1,1,1,1,0]
  ],
  "start": [0, 10],
  "exit": [19, 10],
  "rewards": [
    [[9, 3], 5],
    [[9, 17], 10]
  ],
  "swap_prob": 1.0
}
